5x11
WWWWWWWWWWW
WW WWW   WW
S    W W  F
WW W   WWWW
WWWWWWWWWWW